▉▉▉▉▉▉▉▉▉▉▉▉▉▉▉▉▉▉▉▉▉
▉                   ▉
▉  ╬▉▉▉▉▉▉▉▉▉▉▉⊏⊐▉▉▉▉
▉  ╬▉▉              ▉
▉  ╬▉▉----------▉▉  ▉
▉  ╬▉               ▉
▉  ╬▉▉▉    ------▉  ▉
▉  ╬                ▉
▉  ▉▉▉▉▉    ▉▉▉▉    ▉
▉                   ▉
▉ 2 1    ⭐        T ▉
▉▉▉▉▉▉▉▉▉▉▉▉▉▉▉▉▉▉▉▉▉