▉▉▉▉▉▉▉▉▉▉▉▉▉▉▉▉▉▉▉▉▉
▉     ▉             ▉
▉     ▉        ▉    ▉
▉     ▉▉▉▉⊏⊐▉▉▉▉▉   ▉
▉                   ▉
▉  ▉▉▉▉▉▉▉▉▉▉▉▉▉▉▉▉▉▉
▉                   ▉
▉▉▉▉▉▉▉▉▉▉▉▉▉▉▉▉▉  ▉▉
▉                   ▉
▉▉▉▉             ▉▉▉▉
▉ 2       ⭐       t ▉
▉▉▉▉▉▉▉▉▉▉▉▉▉▉▉▉▉▉▉▉▉