▉▉▉▉▉▉▉▉▉▉▉▉▉▉▉▉▉▉▉▉▉
▉                   ▉
▉  ╬▉▉▉▉▉▉▉▉▉▉▉⊏⊐▉▉▉▉
▉  ╬▉▉          2   ▉
▉  ╬▉▉----------▉▉  ▉
▉  ╬▉               ▉
▉  ╬▉▉▉    ------▉  ▉
▉  ╬                ▉
▉  ▉▉▉▉▉    ▉▉▉▉    ▉
▉                   ▉
▉   1    ⭐        t ▉
▉▉▉▉▉▉▉▉▉▉▉▉▉▉▉▉▉▉▉▉▉