▉▉▉▉▉▉▉▉▉▉▉▉▉▉▉▉▉▉▉▉▉▉▉▉▉▉▉▉▉▉▉▉▉▉▉▉▉▉▉▉▉▉
▉                                        ▉
▉                                        ▉
▉     ▉▉▉▉⊏⊐▉▉▉▉                         ▉
▉                                        ▉
▉                                        ▉
▉                                        ▉
▉                                        ▉
▉                                        ▉
▉                                        ▉
▉                                        ▉
▉                                        ▉
▉                                        ▉
▉    ╬╬▉▉▉▉▉▉▉▉▉  ▉▉▉▉▉▉▉▉▉▉▉▉▉  ▉▉▉▉▉▉▉▉▉
▉    ╬╬                                  ▉
▉    ▉▉▉▉▉▉▉▉▉▉▉▉▉▉▉▉▉▉▉╬╬▉▉▉▉▉▉▉▉▉▉▉▉▉▉▉▉
▉                       ╬╬               ▉
▉                       ╬╬               ▉
▉                       ╬╬               ▉
▉              ⭐ ▉▉▉▉▉▉▉▉▉▉▉▉▉▉▉▉▉▉▉▉▉▉▉▉▉
▉          ╬╬▉▉▉▉           1            ▉
▉          ╬╬           ▉▉▉▉▉▉▉▉▉▉▉   ▉▉▉▉
▉ 2        ╬╬                       t    ▉
▉▉▉▉▉▉▉▉▉▉▉▉▉▉▉▉▉▉▉▉▉▉▉▉▉▉▉▉▉▉▉▉▉▉▉▉▉▉▉▉▉▉