▉▉▉▉▉▉▉▉▉▉▉▉▉▉▉▉▉▉▉▉▉
▉                   ▉
▉                   ▉
▉     ▉▉▉▉⊏⊐▉▉▉▉    ▉
▉                   ▉
▉                   ▉
▉                   ▉
▉              ⭐    ▉
▉           ╬▉▉▉▉   ▉
▉           ╬       ▉
▉ 2         ╬       ▉
▉▉▉▉▉▉▉▉▉▉▉▉▉▉▉▉▉▉▉▉▉